20 15
24 28 25 25 28 25 25 26 25 25 26 25 25 28 25 25 25 26 25 27
34 35 36 30 30 30 35 30 35 38 30 30 38 30 35 30 30 30 31 42
34 30 30 36 35 30 30 35 35 35 35 35 35 35 35 30 31 30 30 42
29 30 30 30 30 30 30 31 30 30 35 35 35 30 30 30 30 30 30 56
29 40 30 30 30 40 30 30 30 35 30 30 30 31 30 30 30 31 30 57
29 30 30 38 30 30 30 35 30 30 40 30 30 30 30 30 30 30 30 57
34 30 30 38 38 30 30 30 30 30 30 30 30 31 30 30 30 30 30 56
34 30 30 30 30 30 30 30 41 30 30 30 30 30 30 30 30 40 30 56
34 51 30 30 30 31 30 30 30 30 40 30 35 30 51 75 63 76 30 56
34 51 30 30 30 30 30 35 35 30 30 30 35 30 51 77 62 67 30 42
34 30 30 65 65 30 30 35 30 30 30 30 73 72 68 59 60 61 30 57
34 30 30 30 65 30 30 40 30 30 30 35 30 30 37 64 65 66 82 56
34 35 30 30 65 30 30 30 30 30 31 30 30 30 30 69 70 71 30 56
34 35 30 30 30 30 30 30 30 30 30 30 40 30 30 79 80 81 30 57
43 43 49 49 53 28 55 28 55 33 54 33 53 33 54 33 33 46 53 53