17 13
14 14 14 14 14 14 14 14 14 14 14 14 14 14 14 14 14
14 0 0 0 0 0 0 0 0 0 0 0 0 0 0 0 14
14 0 0 0 0 0 0 0 0 0 0 0 0 0 0 0 14
14 0 10 10 0 0 0 0 0 0 0 0 0 9 9 0 14
14 0 10 10 0 0 0 0 0 0 0 0 0 9 9 0 14
14 0 0 0 0 0 0 0 0 0 0 0 0 0 0 0 14
14 0 0 0 0 0 0 0 0 0 0 0 0 0 0 0 14
14 0 0 0 0 0 0 0 0 0 0 0 0 0 0 0 14
14 0 0 0 0 0 0 0 0 0 0 0 0 0 0 0 14
14 0 9 9 0 0 0 0 0 0 0 0 0 10 10 0 14
14 0 9 9 0 0 0 0 0 0 0 0 0 10 10 0 14
14 0 0 0 0 0 0 0 0 0 0 0 0 0 0 0 14
14 14 14 14 14 14 14 14 14 14 14 14 14 14 14 14 14